2 2 2 2 2 2 2 2 2 2 2 2 2 2 2 2 2 2 2 2 2 2 2 2 2 2 2 2 2 2 2 2 2 2 2 2 2 2 2 2 2 2 2 2 2 2 2 2 2 2 2 2 2 2 2 2 2 2 2 2 2 2 2 2 2 
2 2 2 2 2 2 2 2 2 2 2 2 2 2 2 2 2 2 2 2 2 2 2 2 2 2 2 2 2 2 2 2 2 2 2 2 2 2 2 2 2 2 2 2 2 2 2 2 2 2 2 2 2 2 2 2 2 2 2 2 2 2 2 2 2 
2 2 2 2 2 2 2 2 2 2 2 2 2 2 2 2 2 2 2 2 2 2 2 2 2 2 2 2 2 2 2 2 2 2 2 2 2 2 2 2 2 2 2 2 2 2 2 2 2 2 2 2 2 2 2 2 2 2 2 2 2 2 2 2 2 
2 2 2 2 2 2 2 2 2 2 2 2 2 2 2 2 2 2 2 2 2 2 2 2 2 2 2 2 2 2 2 2 2 2 2 2 2 2 2 2 2 2 2 2 2 2 2 2 2 2 2 2 2 2 2 2 2 2 2 2 2 2 2 2 2 
2 2 2 2 2 2 2 5 5 5 5 5 5 5 5 5 5 5 5 5 5 5 5 5 5 5 5 5 5 5 5 5 5 5 5 5 5 5 5 5 5 5 5 5 5 5 5 5 5 5 5 5 5 5 5 5 5 5 2 2 2 2 2 2 2 
2 2 2 2 2 2 2 5 4 4 4 4 4 4 4 4 4 4 4 4 4 4 4 4 4 4 4 4 4 4 4 4 4 4 4 4 4 4 4 4 4 4 4 4 4 4 4 4 4 4 4 4 4 4 4 4 4 5 2 2 2 2 2 2 2
2 2 2 2 2 2 2 5 4 4 4 4 4 4 4 4 4 4 4 4 4 4 4 4 4 4 4 4 4 4 4 4 4 4 4 4 4 4 4 4 4 4 4 4 4 4 4 4 4 4 4 4 4 4 4 4 4 5 2 2 2 2 2 2 2
2 2 2 2 2 2 2 5 4 4 4 4 4 4 4 4 4 4 4 4 4 4 4 4 4 4 4 4 4 4 4 4 4 4 4 4 4 4 4 4 4 4 4 4 4 4 4 4 4 4 4 4 4 4 4 4 4 5 2 2 2 2 2 2 2
2 2 2 2 2 2 2 5 4 4 4 3 3 3 3 0 0 0 0 0 0 0 3 3 3 3 3 3 3 3 3 3 3 3 3 3 3 3 3 3 1 1 1 1 1 1 1 1 1 1 1 1 1 4 4 4 4 5 2 2 2 2 2 2 2
2 2 2 2 2 2 2 5 4 4 3 3 3 3 0 0 1 1 1 1 1 0 0 3 3 3 3 3 3 3 3 3 3 3 3 3 3 3 3 3 1 3 3 3 3 3 1 3 3 3 3 3 1 1 1 4 4 5 2 2 2 2 2 2 2
2 2 2 2 2 2 2 5 4 4 3 3 3 3 0 0 1 3 3 3 1 0 0 3 3 3 3 3 3 3 3 3 3 3 3 3 3 3 3 3 1 1 1 3 3 1 1 3 3 3 3 3 3 3 1 4 4 5 2 2 2 2 2 2 2
2 2 2 2 2 2 2 5 4 4 3 3 3 0 0 0 1 3 3 3 1 0 0 0 3 3 3 3 3 3 3 3 3 3 3 3 3 3 3 3 1 3 3 3 1 1 3 3 3 3 3 3 3 3 1 4 4 5 2 2 2 2 2 2 2
2 2 2 2 2 2 2 5 4 4 3 3 3 0 0 0 1 3 3 3 1 0 0 0 3 3 3 3 3 3 3 3 3 3 3 3 3 3 3 3 1 3 3 1 3 3 3 1 1 1 1 1 3 1 1 4 4 5 2 2 2 2 2 2 2
2 2 2 2 2 2 2 5 4 4 3 3 3 3 0 0 1 3 3 3 1 0 0 0 3 3 3 3 3 3 3 3 3 3 3 3 3 3 3 3 1 3 3 1 3 3 3 3 3 3 3 1 3 3 1 4 4 5 2 2 2 2 2 2 2
2 2 2 2 2 2 2 5 4 4 3 3 3 3 0 0 1 1 3 1 1 0 0 3 3 3 3 3 3 3 3 3 3 3 3 3 3 3 3 3 1 3 3 1 1 1 1 1 3 3 3 1 1 3 1 4 4 5 2 2 2 2 2 2 2
2 2 2 2 2 2 2 5 4 4 3 3 3 3 3 0 0 5 5 0 0 0 3 3 3 3 3 3 3 3 3 3 3 3 3 3 3 3 3 3 1 3 3 3 3 3 3 1 3 3 3 1 3 3 1 4 4 5 2 2 2 2 2 2 2
2 2 2 2 2 2 2 5 4 4 3 3 3 3 3 3 0 0 5 5 0 0 3 3 3 3 3 3 3 3 3 3 3 3 3 3 3 3 3 3 1 3 3 1 1 1 3 1 3 3 3 1 3 1 1 4 4 5 2 2 2 2 2 2 2
2 2 2 2 2 2 2 5 4 4 3 3 3 3 3 3 3 0 5 5 0 3 3 3 3 3 3 3 3 3 3 3 3 3 3 3 3 3 3 3 1 3 3 1 3 1 3 1 1 1 1 1 3 3 1 4 4 5 2 2 2 2 2 2 2
2 2 2 2 2 2 2 5 4 4 3 3 3 3 3 3 0 0 5 5 0 3 3 3 3 3 3 3 3 3 3 3 3 3 3 3 3 3 3 3 1 3 3 3 3 1 3 3 3 3 1 1 3 3 1 4 4 5 2 2 2 2 2 2 2
2 2 2 2 2 2 2 5 4 4 3 3 3 3 3 3 0 5 5 0 0 3 3 3 3 3 3 3 3 3 3 3 3 3 3 3 3 3 3 3 1 3 3 1 1 1 1 1 1 3 1 1 1 3 1 4 4 5 2 2 2 2 2 2 2
2 2 2 2 2 2 2 5 4 4 3 3 3 3 3 3 0 5 5 0 3 3 3 3 3 3 3 3 3 3 9 3 3 3 9 3 3 3 3 3 1 3 3 3 3 3 3 3 1 3 3 3 3 3 1 4 4 5 2 2 2 2 2 2 2
2 2 2 2 2 2 2 5 4 4 3 3 3 3 3 0 0 5 5 0 3 3 3 3 3 3 3 3 3 3 8 3 3 8 3 3 3 3 3 3 1 1 1 1 1 1 1 1 1 1 3 1 1 1 1 4 4 5 2 2 2 2 2 2 2
2 2 2 2 2 2 2 5 4 4 3 3 3 3 3 0 0 5 5 5 5 5 5 5 5 5 5 5 5 5 5 5 5 5 5 5 5 5 5 5 5 5 5 5 5 5 5 5 5 5 5 5 5 5 5 4 4 5 2 2 2 2 2 2 2
2 2 2 2 2 2 2 5 4 4 3 3 3 3 3 0 5 5 0 3 3 3 3 3 3 3 3 3 3 3 6 6 3 3 3 3 3 3 3 3 3 3 5 3 3 3 3 3 3 3 3 3 3 3 3 4 4 5 2 2 2 2 2 2 2
2 2 2 2 2 2 2 5 4 4 3 3 3 3 3 3 5 5 3 3 3 3 3 3 3 3 3 3 3 3 3 5 3 3 3 3 3 3 3 3 3 3 5 3 3 3 3 3 3 3 3 3 3 3 3 4 4 5 2 2 2 2 2 2 2
2 2 2 2 2 2 2 5 4 4 3 3 3 3 3 3 3 5 5 3 3 3 3 3 3 3 3 3 3 3 3 3 3 3 3 3 3 3 3 3 3 3 5 3 3 3 3 3 3 3 3 3 3 3 3 4 4 5 2 2 2 2 2 2 2
2 2 2 2 2 2 2 5 4 4 3 3 3 3 3 3 3 5 5 3 3 3 3 3 3 3 3 3 3 3 3 3 3 3 3 3 3 3 3 3 3 3 5 3 3 3 3 3 3 3 3 3 3 3 3 4 4 5 2 2 2 2 2 2 2
2 2 2 2 2 2 2 5 4 4 3 3 3 3 3 3 3 5 5 3 3 3 3 3 3 3 3 3 3 4 4 4 4 4 4 4 4 4 4 4 4 4 4 4 4 4 4 4 4 4 4 4 4 4 3 4 4 5 2 2 2 2 2 2 2
2 2 2 2 2 2 2 5 4 4 3 3 3 3 3 3 5 5 3 3 3 3 3 3 3 3 3 3 3 4 4 4 4 4 4 4 4 4 4 4 4 4 4 4 4 4 4 4 4 4 4 4 4 4 3 4 4 5 2 2 2 2 2 2 2
2 2 2 2 2 2 2 5 4 4 3 3 3 3 3 3 5 5 3 3 3 3 3 3 3 3 3 3 3 4 4 4 4 4 4 4 4 4 4 4 4 4 4 4 4 4 4 4 4 4 4 4 4 4 3 4 4 5 2 2 2 2 2 2 2
2 2 2 2 2 2 2 5 4 4 3 3 3 3 3 5 5 3 3 3 3 3 3 3 3 3 3 3 3 4 4 4 4 4 4 4 4 4 4 4 4 4 4 4 4 4 4 4 4 4 4 4 4 4 3 4 4 5 2 2 2 2 2 2 2
2 2 2 2 2 2 2 5 4 4 3 3 3 3 3 5 5 3 3 3 3 3 3 3 3 3 3 3 3 4 4 4 4 4 4 4 4 4 4 4 4 4 4 4 4 4 4 4 4 4 4 4 4 4 3 4 4 5 2 2 2 2 2 2 2
2 2 2 2 2 2 2 5 4 4 3 3 3 3 3 3 3 3 3 3 3 3 3 3 3 3 3 3 3 4 4 4 4 4 4 4 4 4 4 4 4 4 4 4 4 4 4 4 4 4 4 4 4 4 3 4 4 5 2 2 2 2 2 2 2
2 2 2 2 2 2 2 5 4 4 3 3 3 2 2 2 2 2 2 2 3 3 3 3 3 3 3 3 3 4 4 4 4 4 4 4 4 4 4 4 4 4 4 4 4 4 4 4 4 4 4 4 4 0 3 4 4 5 2 2 2 2 2 2 2
2 2 2 2 2 2 2 5 4 4 3 3 3 2 2 2 2 2 2 2 3 3 3 3 3 3 3 3 3 4 4 4 4 4 4 4 4 4 4 4 4 4 4 4 4 4 4 4 4 4 4 4 4 4 3 4 4 5 2 2 2 2 2 2 2
2 2 2 2 2 2 2 5 4 4 3 3 3 2 2 2 2 2 2 2 3 3 3 3 3 3 3 3 3 4 4 4 4 4 4 4 4 4 4 4 4 4 4 4 4 4 4 4 4 4 4 4 4 4 3 4 4 5 2 2 2 2 2 2 2
2 2 2 2 2 2 2 5 4 4 3 3 3 2 2 2 2 2 2 2 3 3 3 3 3 3 3 3 3 4 4 4 4 4 4 4 4 4 4 4 4 4 4 4 4 4 4 4 4 4 4 4 4 4 3 4 4 5 2 2 2 2 2 2 2
2 2 2 2 2 2 2 5 4 4 3 3 3 2 2 2 2 2 2 2 3 3 3 3 3 3 3 3 3 4 4 4 4 4 4 4 4 4 4 4 4 4 4 4 4 4 4 4 4 4 4 4 4 4 3 4 4 5 2 2 2 2 2 2 2
2 2 2 2 2 2 2 5 4 4 3 3 3 2 2 2 2 2 2 2 3 3 3 3 3 3 3 3 3 4 4 4 4 4 4 4 4 4 4 4 4 4 4 4 4 4 4 4 4 4 4 4 4 4 3 4 4 5 2 2 2 2 2 2 2
2 2 2 2 2 2 2 5 4 4 3 3 3 2 2 2 2 2 2 2 3 3 3 3 3 3 3 3 3 4 4 4 4 4 4 4 4 4 4 4 4 4 4 4 4 4 4 4 4 4 4 4 4 4 3 4 4 5 2 2 2 2 2 2 2
2 2 2 2 2 2 2 5 4 4 3 3 3 3 3 3 3 3 3 3 3 3 3 3 3 3 3 3 3 4 4 4 4 4 4 4 4 4 4 4 4 4 4 4 4 4 4 4 4 4 4 4 4 4 3 4 4 5 2 2 2 2 2 2 2
2 2 2 2 2 2 2 5 4 4 3 3 3 3 3 3 3 3 3 3 3 3 3 3 3 3 3 3 3 4 4 4 4 4 4 4 4 4 4 4 4 4 4 4 4 4 4 4 4 4 4 4 4 4 3 4 4 5 2 2 2 2 2 2 2
2 2 2 2 2 2 2 5 4 4 3 3 3 3 3 3 3 3 3 3 3 3 3 3 3 3 3 3 3 3 3 3 3 3 3 3 3 3 3 3 3 3 3 3 3 3 3 3 3 3 3 3 3 3 3 4 4 5 2 2 2 2 2 2 2
2 2 2 2 2 2 2 5 4 4 3 3 3 3 3 3 3 3 3 3 3 3 3 3 3 3 3 3 3 3 3 3 3 3 3 3 3 3 3 3 3 3 3 3 3 3 3 3 3 3 3 3 3 3 3 4 4 5 2 2 2 2 2 2 2
2 2 2 2 2 2 2 5 4 4 3 3 3 3 3 3 3 3 3 3 3 3 3 3 3 3 3 3 3 3 3 3 3 3 3 3 3 3 3 3 3 3 3 3 3 3 3 3 3 3 3 3 3 3 3 4 4 5 2 2 2 2 2 2 2
2 2 2 2 2 2 2 5 4 4 3 3 3 3 3 3 3 3 3 3 3 3 3 3 3 3 3 3 3 3 3 3 3 3 3 3 3 3 3 3 3 3 3 3 3 3 3 3 3 3 3 3 3 3 3 4 4 5 2 2 2 2 2 2 2
2 2 2 2 2 2 2 5 4 4 3 3 3 3 3 3 3 3 3 3 3 3 3 3 3 3 3 3 3 3 3 3 3 3 3 3 3 3 3 3 3 3 3 3 3 3 3 3 3 3 3 3 3 3 3 4 4 5 2 2 2 2 2 2 2
2 2 2 2 2 2 2 5 4 4 4 3 3 3 3 3 3 3 3 3 3 3 3 3 3 3 3 3 3 3 3 3 3 3 3 3 3 3 3 3 3 3 3 3 3 3 3 3 3 3 3 3 3 4 4 4 4 5 2 2 2 2 2 2 2
2 2 2 2 2 2 2 5 4 4 4 4 4 4 4 4 4 4 3 3 3 3 3 3 3 3 3 3 3 3 3 3 3 3 3 3 3 3 3 3 3 3 3 3 3 3 3 3 4 4 4 4 4 4 4 4 4 5 2 2 2 2 2 2 2
2 2 2 2 2 2 2 5 4 4 4 4 4 4 4 4 4 4 4 4 4 4 4 4 4 4 3 3 3 3 3 3 3 3 3 3 3 3 3 3 3 4 4 4 4 4 4 4 4 4 4 4 4 4 4 4 4 5 2 2 2 2 2 2 2
2 2 2 2 2 2 2 5 4 4 4 4 4 4 4 4 4 4 4 4 4 4 4 4 4 4 4 4 4 4 4 4 4 4 4 4 4 4 4 4 4 4 4 4 4 4 4 4 4 4 4 4 4 4 4 4 4 5 2 2 2 2 2 2 2
2 2 2 2 2 2 2 5 4 4 4 4 4 4 4 4 4 4 4 4 4 4 4 4 4 4 4 4 4 4 4 4 4 4 4 4 4 4 4 4 4 4 4 4 4 4 4 4 4 4 4 4 4 4 4 4 4 5 2 2 2 2 2 2 2
2 2 2 2 2 2 2 5 5 5 5 5 5 5 5 5 5 5 5 5 5 5 5 5 5 5 5 5 5 5 5 5 5 5 5 5 5 5 5 5 5 5 5 5 5 5 5 5 5 5 5 5 5 5 5 5 5 5 2 2 2 2 2 2 2 
2 2 2 2 2 2 2 2 2 2 2 2 2 2 2 2 2 2 2 2 2 2 2 2 2 2 2 2 2 2 2 2 2 2 2 2 2 2 2 2 2 2 2 2 2 2 2 2 2 2 2 2 2 2 2 2 2 2 2 2 2 2 2 2 2 
2 2 2 2 2 2 2 2 2 2 2 2 2 2 2 2 2 2 2 2 2 2 2 2 2 2 2 2 2 2 2 2 2 2 2 2 2 2 2 2 2 2 2 2 2 2 2 2 2 2 2 2 2 2 2 2 2 2 2 2 2 2 2 2 2 
2 2 2 2 2 2 2 2 2 2 2 2 2 2 2 2 2 2 2 2 2 2 2 2 2 2 2 2 2 2 2 2 2 2 2 2 2 2 2 2 2 2 2 2 2 2 2 2 2 2 2 2 2 2 2 2 2 2 2 2 2 2 2 2 2 
2 2 2 2 2 2 2 2 2 2 2 2 2 2 2 2 2 2 2 2 2 2 2 2 2 2 2 2 2 2 2 2 2 2 2 2 2 2 2 2 2 2 2 2 2 2 2 2 2 2 2 2 2 2 2 2 2 2 2 2 2 2 2 2 2 